11111111111
10000000001
10000N00101
10000000001
11111111111