1111111111111
1000000000001
1011000000N01
1000000000001
0111111111110